11111111
10001C01
10E01111
10C000P1
11111111