1111111111111111111111111111111111111111111111111111111111111111111111111111111111111111111111111111111111111111111111111111111111111111111111111111111111111111111111111111111111111111111111111111111111111111111111111111111111111111111111111111111111111111111111111111111111111111111111111111111111111111111111111111111111111111111111111111111111111111111111111111111111111111111111111111111111111111111111111111111111111111111111111111111111111111111111111111111111111111111111111111111111111111111111111111111111111111111111111111111111111111111111111111111111111111111111111111111111111111111111111111111111111111111111111111111111111111111111111111111111111111111111111111111111111111111111111111111111111111111111111111111111111111
1010000000000000001000000000000000100000000000000010000000000000001000000000000000100000000000000010000000000000001000000000000000100000000000000010000000000000001000000000000000100000000000000010000000000000001000000000000000100000000000000010000000000000001000000000000000100000000000000010000000000000001000000000000000100000000000000010000000000000001000000000000000100000000000000010000000000000001000000000000000100000000000000010000000000000001000000000000000100000000000000010000000000000001000000000000000100000000000000010000000000000001000000000000000100000000000000010000000000000001000000000000000100000000000000010000000000000001000000000000000100000000000000010000000000000001000000000000000100000000000000010000000000001
1100101001000001010010000000101001001010010000010100100000001010010010100100000101001000000010100100101001000001010010000000101001001010010000010100100000001010010010100100000101001000000010100100101001000001010010000000101001001010010000010100100000001010010010100100000101001000000010100100101001000001010010000000101001001010010000010100100000001010010010100100000101001000000010100100101001000001010010000000101001001010010000010100100000001010010010100100000101001000000010100100101001000001010010000000101001001010010000010100100000001010010010100100000101001000000010100100101001000001010010000000101001001010010000010100100000001010010010100100000101001000000010100100101001000001010010000000101001001010010000010100100000001011
1100100101010100010010000000101011001001010101000100100000001010110010010101010001001000000010101100100101010100010010000000101011001001010101000100100000001010110010010101010001001000000010101100100101010100010010000000101011001001010101000100100000001010110010010101010001001000000010101100100101010100010010000000101011001001010101000100100000001010110010010101010001001000000010101100100101010100010010000000101011001001010101000100100000001010110010010101010001001000000010101100100101010100010010000000101011001001010101000100100000001010110010010101010001001000000010101100100101010100010010000000101011001001010101000100100000001010110010010101010001001000000010101100100101010100010010000000101011001001010101000100100000001011
1001000P0C0E0000000000000000001000010000000000000000000000000010000100000000000000000000000000100001000000000000000000000000001000010000000000000000000000000010000100000000000000000000000000100001000000000000000000000000001000010000000000000000000000000010000100000000000000000000000000100001000000000000000000000000001000010000000000000000000000000010000100000000000000000000000000100001000000000000000000000000001000010000000000000000000000000010000100000000000000000000000000100001000000000000000000000000001000010000000000000000000000000010000100000000000000000000000000100001000000000000000000000000001000010000000000000000000000000010000100000000000000000000000000100001000000000000000000000000001000010000000000000000000000000011
1111111111111111111111111111111111111111111111111111111111111111111111111111111111111111111111111111111111111111111111111111111111111111111111111111111111111111111111111111111111111111111111111111111111111111111111111111111111111111111111111111111111111111111111111111111111111111111111111111111111111111111111111111111111111111111111111111111111111111111111111111111111111111111111111111111111111111111111111111111111111111111111111111111111111111111111111111111111111111111111111111111111111111111111111111111111111111111111111111111111111111111111111111111111111111111111111111111111111111111111111111111111111111111111111111111111111111111111111111111111111111111111111111111111111111111111111111111111111111111111111111111111111111