111111111111111111
111111P01111111111
111111001111111111
1000C0000000000C01
100000000000000001
1C0000C00000C00001
1000C1111110000001
111111111111100C11
1111111111111E1111
111111111111111111