1111111111111111111111111111111111111111111111111
1000000100001100001000101000100011111111111111111
1001000110001100001001010000000011111111111111111
111100010111000C110000000110000011111111111111111
1000000100000000011110101010110011111111111111111
1111110001111P10100100011010010011111111111111111
1100010000010110100110000010110011111111111111111
1000100001011001010000101001000011111111111111111
1001101000000100010010000010100011111111111111111
1000101000000000001011100010000011111111111111111
100110100011110011000C011000000111111111111111111
1000000000001001110001000110001011111111111111111
1000001011100100000110000000010111111111111111111
100000001100100101000000E000011011111111111111111
101100010111101011C001000000C01111111111111111111
1000001011100000110000000000000011111111111111111
1100000000010101101001010001010011111111111111111
11C0001C0000010110C000000000000011111111111111111
10011100000000010011010000C0011111111111111111111
1111111111111111111111111111111111111111111111111
1111111111111111111111111111111111111111111111111
1111111111111111111111111111111111111111111111111
1111111111111111111111111111111111111111111111111
1111111111111111111111111111111111111111111111111
1111111111111111111111111111111111111111111111111