1111111111111111111
1100P0C0000C0000111
1111110C11111111111
1111110111111111111
11111000C1111111111
11100C0111111111111
10000000000C0000C01
111111111111000C111
1000000C0C000CEC001
1111111111111111111