111111111111
10C0000000P1
100111111111
1E00000000C1
111111111111