11111111111111
1P0100010100E1
100E0000000001
10100000000001
10000000000001
10101C10001111
11111111111111